00000000000000S+++++++++++++00000000000000000000x+++++-------++++++x00000000000000000000000000000000000000000000000000000#
000000000000000000000000000+00000000000000000000+000000000000000000+00000000000000000000000000++++++++++x0000000000000000#
000000000000000000000000000+00000000000000000000+000000000000000000+00000000000000000000000000-000000000+0000000000000000#
000000000000000000000000000+00000000000000000000+000000000000000000+00000000000000000000000000-000000000x+++++++------+x0#
000000000000000000000000000-00000000000000000000+++++++++0000000000+00000000000000000000000000-000000000000000000000000+0#
000000000000000000000000000-0000000000000000000000000000+0000000000+00000000000000000000000000-000000000000000000000000+0#
000000000000000000000000000-0000000000000000000000000000+0000000000+00000000000000000000000000-000000000000000000000000+0#
000000000000000000000000000-0000000000000000000000000000+0000000000-00000000000000000000000000-000000000000000000000000+0#
000000000000000000000000000-0000000000000000000000000000+0000000000-00000000000000000000000000++++++++++++x000000000000+0#
000000000000000x+-----++++++0000000000000000000000000000+0000000000-00000000000000000000000000000000000000+000000000000+0#
000000000000000+0000000000000000000000000000000000000000-0000000000-00000000000000000000000000000000000000-000000000000+0#
000000000000000-0000000000000000000000000000000000000000-0000000000-00000000000000000000000000000000000000-000000000000+0#
000000000000000-0000000000000000000000000000000000000000-0000000000-00000000000000000000000000000000000000-000000000000+0#
000000000000000-0000000000000000000000000000000000000000-0000000000-00000000000000000000000000000000000000-000000000000-0#
000000000000000-000000x+++++++00000000000000000000000000-0000000000-00000000000000000000000000000000000000-000000000000-0#
000000000000000-000000+000000-00000000000000000000000000-0000000000-00000000000000000000000000000000000000-000000000000-0#
000000000000000-000000+000000-00000000000000000000000000-0000000000-0000000000000000x++++++++0000000000000-000000000000-0#
000000000000000++++++++000000-00000000000000000000000000-0000000000-0000000000000000+0000000+0000000000000-000000000000-0#
00000000000000000000000000000-00000000000000000000000000-0000000000++++0000000000000+0000000+0000000000000-000000000000-0#
00000000000000000000000000000-00000000000000000000000000-0000000000000+0000000000000+0000000-0000000000000-000000000000+0#
00000000000000000000000000000-00000000000000000000000000+0000000000000+0000000000000+0000000-0000000000000-00000000000xx0#
00000000000000000000000000000-00000000000000000000000000+0000000000000+0000000000000+0000000-0000000000000-00000000000+00#
00000000000000000000000000000-000000000000x++-------+++++0000000000000+-------------+0000000-0000000000000-00000000000-00#
00000000000000000000000000000-000000000000+0000000000000000000000000000000000000000000000000-0000000000000-00000000000-00#
00000000000000000000000000000+000000000000+0000000000000000000000000000000000000000000000000-0000000000000-00000000000-00#
00000000000000000000000000000++----------+x0000000000000000000000000000000000000000000000000-0000000000000-00000000000-00#
00000000000000000000000000000000000000000000000000000000000000000000000000000000000000000000+0000000000000+00000000000-00#
00000000000000000000000000000000000000000000000000000000000000000000000000000000000000000000x+-----------+x00000000000-00#
0000000000000000000000000000000000000000000000000000000000000000000000000000000000000000000000000000000000000000000000-00#
0000000000000000000000000000000000000000000000000000000000000000000000000000000000000000000000000000000000000000000000-00#
0000000000000000000000000000000000000000000000000000000000000000000000000000000000000000000000000000000000000000000000-00#
0000000000000000000000000000000000000000000000000000000000000000000000000000000000000000000000000000000000000000000000=00#
0000000000000000000000000000000000000000000000000000000000000000000000000000000000000000000000000000000000000000000000000#
0000000000000000000000000000000000000000000000000000000000000000000000000000000000000000000000000000000000000000000000000#
0000000000000000000000000000000000000000000000000000000000000000000000000000000000000000000000000000000000000000000000000#